{
    "San Martino di Castrozza, Primiero e Vanoi": [
        "22115",
        "22038",
        "22097",
        "22164",
        "22245"
    ],
    "Val di Non": [
        "22170",
        "22026",
        "22252",
        "22242",
        "22060",
        "22200",
        "22169",
        "22051",
        "22173",
        "22237",
        "22155",
        "22162",
        "22037",
        "22181",
        "22230",
        "22071",
        "22253",
        "22159",
        "22249",
        "22074",
        "22062",
        "22163",
        "22106"
    ],
    "Rovereto, Vallagarina e Monte Baldo": [
        "22025",
        "22161",
        "22224",
        "22203",
        "22193",
        "22001",
        "22222",
        "22210",
        "22098",
        "22127",
        "22144",
        "22035",
        "22013",
        "22135",
        "22123",
        "22128",
        "22007"
    ],
    "Val di Fassa": [
        "22118",
        "22250",
        "22039",
        "22036",
        "22113",
        "22176"
    ],
    "Val di Sole": [
        "22068",
        "22136",
        "22233",
        "22064",
        "22114",
        "22033",
        "22195",
        "22054",
        "22150",
        "22137",
        "22213",
        "22131",
        "22110"
    ],
    "Altopiano della Paganella, Piana della Rotaliana e San Lorenzo Dorsino": [
        "22251",
        "22081",
        "22120",
        "22005",
        "22231",
        "22052",
        "22103",
        "22180",
        "22167",
        "22117",
        "22160",
        "22116"
    ],
    "Madonna di Campiglio, Pinzolo, Val Rendena, Giudicarie centrali e Valle del Chiese": [
        "22045",
        "22138",
        "22018",
        "22093",
        "22232",
        "22112",
        "22179",
        "22143",
        "22199",
        "22238",
        "22184",
        "22029",
        "22183",
        "22244",
        "22042",
        "22246",
        "22021",
        "22239",
        "22234"
    ],
    "Val di Fiemme e Val di Cembra": [
        "22092",
        "22177",
        "22047",
        "22147",
        "22235",
        "22254",
        "22196",
        "22040",
        "22050",
        "22241",
        "22226",
        "22134",
        "22209",
        "22172"
    ],
    "Valsugana, Tesino e Valle dei Mocheni": [
        "22049",
        "22133",
        "22139",
        "22032",
        "22043",
        "22061",
        "22059",
        "22156",
        "22085",
        "22104",
        "22130",
        "22129",
        "22240",
        "22157",
        "22189",
        "22142",
        "22216",
        "22090",
        "22015",
        "22034",
        "22165",
        "22202",
        "22048",
        "22095",
        "22022",
        "22188",
        "22168",
        "22190",
        "22171"
    ],
    "Trento, Monte Bondone e Altopiano di Pinè": [
        "22091",
        "22002",
        "22058",
        "22003",
        "22108",
        "22205",
        "22011",
        "22009",
        "22089"
    ],
    "Garda trentino, Valle di Ledro, Terme di Comano e Valle dei Laghi": [
        "22243",
        "22006",
        "22083",
        "22078",
        "22229",
        "22079",
        "22182",
        "22191",
        "22153",
        "22247",
        "22124",
        "22228",
        "22053",
        "22017",
        "22248"
    ],
    "Altipiani cimbri e Vigolana": [
        "22087",
        "22236",
        "22109",
        "22102"
    ]
}